Stingers:
Abraded Bluffs | ['Desert'] | This land enters tapped. When this land enters, it deals 1 damage to target opponent. {T}: Add {R} or {W}.
Bristling Backwoods | ['Desert'] | This land enters tapped. When this land enters, it deals 1 damage to target opponent. {T}: Add {R} or {G}.
Creosote Heath | ['Desert'] | This land enters tapped. When this land enters, it deals 1 damage to target opponent. {T}: Add {G} or {W}.
Eroded Canyon | ['Desert'] | This land enters tapped. When this land enters, it deals 1 damage to target opponent. {T}: Add {U} or {R}.
Festering Gulch | ['Desert'] | This land enters tapped. When this land enters, it deals 1 damage to target opponent. {T}: Add {B} or {G}.
Forlorn Flats | ['Desert'] | This land enters tapped. When this land enters, it deals 1 damage to target opponent. {T}: Add {W} or {B}.
Jagged Barrens | ['Desert'] | This land enters tapped. When this land enters, it deals 1 damage to target opponent. {T}: Add {B} or {R}.
Lonely Arroyo | ['Desert'] | This land enters tapped. When this land enters, it deals 1 damage to target opponent. {T}: Add {W} or {U}.
Lush Oasis | ['Desert'] | This land enters tapped. When this land enters, it deals 1 damage to target opponent. {T}: Add {G} or {U}.
Soured Springs | ['Desert'] | This land enters tapped. When this land enters, it deals 1 damage to target opponent. {T}: Add {U} or {B}.

Guildgates:
Azorius Guildgate | ['Gate'] | This land enters tapped. {T}: Add {W} or {U}.
Boros Guildgate | ['Gate'] | This land enters tapped. {T}: Add {R} or {W}.
Dimir Guildgate | ['Gate'] | This land enters tapped. {T}: Add {U} or {B}.
Golgari Guildgate | ['Gate'] | This land enters tapped. {T}: Add {B} or {G}.
Gruul Guildgate | ['Gate'] | This land enters tapped. {T}: Add {R} or {G}.
Izzet Guildgate | ['Gate'] | This land enters tapped. {T}: Add {U} or {R}.
Orzhov Guildgate | ['Gate'] | This land enters tapped. {T}: Add {W} or {B}.
Rakdos Guildgate | ['Gate'] | This land enters tapped. {T}: Add {B} or {R}.
Selesnya Guildgate | ['Gate'] | This land enters tapped. {T}: Add {G} or {W}.
Simic Guildgate | ['Gate'] | This land enters tapped. {T}: Add {G} or {U}.

Towns:
Balamb Garden, SeeD Academy // Balamb Garden, Airborne | {'Vehicle', 'Town'} | This land enters tapped. {T}: Add {G} or {U}. {5}{G}{U}, {T}: Transform this land. This ability costs {1} less to activate for each other Town you control. // Flying Whenever Balamb Garden attacks, draw a card. Crew 1 (Tap any number of creatures you control with total power 1 or more: This Vehicle becomes an artifact creature until end of turn.)
Baron, Airship Kingdom | ['Town'] | This land enters tapped. {T}: Add {U} or {R}.
Gohn, Town of Ruin | ['Town'] | This land enters tapped. {T}: Add {B} or {G}.
Gongaga, Reactor Town | ['Town'] | This land enters tapped. {T}: Add {R} or {G}.
Guadosalam, Farplane Gateway | ['Town'] | This land enters tapped. {T}: Add {G} or {U}.
Insomnia, Crown City | ['Town'] | This land enters tapped. {T}: Add {W} or {B}.
Rabanastre, Royal City | ['Town'] | This land enters tapped. {T}: Add {R} or {W}.
Sharlayan, Nation of Scholars | ['Town'] | This land enters tapped. {T}: Add {W} or {U}.
Treno, Dark City | ['Town'] | This land enters tapped. {T}: Add {U} or {B}.
Vector, Imperial Capital | ['Town'] | This land enters tapped. {T}: Add {B} or {R}.
Windurst, Federation Center | ['Town'] | This land enters tapped. {T}: Add {G} or {W}.


Misc (includes some cycles, I just bulk regexed for these eventually):
Coastal Tower | [] | Coastal Tower enters tapped. {T}: Add {W} or {U}.
Arctic Flats | [] | This land enters tapped. {T}: Add {G} or {W}.
Ballroom | [] | This land enters tapped. {T}: Add {W} or {B}. {4}, {T}: Investigate. (Create a Clue token. It's an artifact with "{2}, Sacrifice this token: Draw a card.")
Billiard Room | [] | This land enters tapped. {T}: Add {B} or {R}. {4}, {T}: Investigate. (Create a Clue token. It's an artifact with "{2}, Sacrifice this token: Draw a card.")
Boreal Shelf | [] | This land enters tapped. {T}: Add {W} or {U}.
Botanical Plaza | [] | This land enters tapped. {T}: Add {G} or {W}. {2}{G}{W}, {T}, Sacrifice this land: Draw a card.
Celestial Colonnade | [] | This land enters tapped. {T}: Add {W} or {U}. {3}{W}{U}: Until end of turn, this land becomes a 4/4 white and blue Elemental creature with flying and vigilance. It's still a land.
Cinder Barrens | [] | This land enters tapped. {T}: Add {B} or {R}.
Conservatory | [] | This land enters tapped. {T}: Add {G} or {W}. {4}, {T}: Investigate. (Create a Clue token. It's an artifact with "{2}, Sacrifice this token: Draw a card.")
Creeping Tar Pit | [] | This land enters tapped. {T}: Add {U} or {B}. {1}{U}{B}: This land becomes a 3/2 blue and black Elemental creature until end of turn and can't be blocked this turn. It's still a land.
Darkmoss Bridge | [] | This land enters tapped. Indestructible {T}: Add {B} or {G}.
Dining Room | [] | This land enters tapped. {T}: Add {R} or {G}. {4}, {T}: Investigate. (Create a Clue token. It's an artifact with "{2}, Sacrifice this token: Draw a card.")
Drossforge Bridge | [] | This land enters tapped. Indestructible {T}: Add {B} or {R}.
Elfhame Palace | [] | This land enters tapped. {T}: Add {G} or {W}.
Forsaken Sanctuary | [] | This land enters tapped. {T}: Add {W} or {B}.
Foul Orchard | [] | This land enters tapped. {T}: Add {B} or {G}.
Frost Marsh | [] | This land enters tapped. {T}: Add {U} or {B}.
Goldmire Bridge | [] | This land enters tapped. Indestructible {T}: Add {W} or {B}.
Hall | [] | This land enters tapped. {T}: Add {R} or {W}. {4}, {T}: Investigate. (Create a Clue token. It's an artifact with "{2}, Sacrifice this token: Draw a card.")
Highland Lake | [] | This land enters tapped. {T}: Add {U} or {R}.
Highland Weald | [] | This land enters tapped. {T}: Add {R} or {G}.
Hissing Quagmire | [] | This land enters tapped. {T}: Add {B} or {G}. {1}{B}{G}: This land becomes a 2/2 black and green Elemental creature with deathtouch until end of turn. It's still a land.
Kitchen | [] | This land enters tapped. {T}: Add {G} or {U}. {4}, {T}: Investigate. (Create a Clue token. It's an artifact with "{2}, Sacrifice this token: Draw a card.")
Lavaclaw Reaches | [] | This land enters tapped. {T}: Add {B} or {R}. {1}{B}{R}: Until end of turn, this land becomes a 2/2 black and red Elemental creature with "{X}: This creature gets +X/+0 until end of turn." It's still a land.
Library | [] | This land enters tapped. {T}: Add {U} or {R}. {4}, {T}: Investigate. (Create a Clue token. It's an artifact with "{2}, Sacrifice this token: Draw a card.")
Lorehold Campus | [] | This land enters tapped. {T}: Add {R} or {W}. {4}, {T}: Scry 1.
Lounge | [] | This land enters tapped. {T}: Add {B} or {G}. {4}, {T}: Investigate. (Create a Clue token. It's an artifact with "{2}, Sacrifice this token: Draw a card.")
Lumbering Falls | [] | This land enters tapped. {T}: Add {G} or {U}. {2}{G}{U}: This land becomes a 3/3 green and blue Elemental creature with hexproof until end of turn. It's still a land.
Meandering River | [] | This land enters tapped. {T}: Add {W} or {U}.
Mistvault Bridge | [] | This land enters tapped. Indestructible {T}: Add {U} or {B}.
Needle Spires | [] | This land enters tapped. {T}: Add {R} or {W}. {2}{R}{W}: This land becomes a 2/1 red and white Elemental creature with double strike until end of turn. It's still a land.
Prismari Campus | [] | This land enters tapped. {T}: Add {U} or {R}. {4}, {T}: Scry 1.
Quandrix Campus | [] | This land enters tapped. {T}: Add {G} or {U}. {4}, {T}: Scry 1.
Racers' Ring | [] | This land enters tapped. {T}: Add {R} or {G}. {2}{R}{G}, {T}, Sacrifice this land: Draw a card.
Raging Ravine | [] | This land enters tapped. {T}: Add {R} or {G}. {2}{R}{G}: Until end of turn, this land becomes a 3/3 red and green Elemental creature with "Whenever this creature attacks, put a +1/+1 counter on it." It's still a land.
Razortide Bridge | [] | This land enters tapped. Indestructible {T}: Add {W} or {U}.
Restless Anchorage | [] | This land enters tapped. {T}: Add {W} or {U}. {1}{W}{U}: Until end of turn, this land becomes a 2/3 white and blue Bird creature with flying. It's still a land. Whenever this land attacks, create a Map token.
Restless Bivouac | [] | This land enters tapped. {T}: Add {R} or {W}. {1}{R}{W}: This land becomes a 2/2 red and white Ox creature until end of turn. It's still a land. Whenever this land attacks, put a +1/+1 counter on target creature you control.
Restless Cottage | [] | This land enters tapped. {T}: Add {B} or {G}. {2}{B}{G}: This land becomes a 4/4 black and green Horror creature until end of turn. It's still a land. Whenever this land attacks, create a Food token and exile up to one target card from a graveyard.
Restless Fortress | [] | This land enters tapped. {T}: Add {W} or {B}. {2}{W}{B}: This land becomes a 1/4 white and black Nightmare creature until end of turn. It's still a land. Whenever this land attacks, defending player loses 2 life and you gain 2 life.
Restless Prairie | [] | This land enters tapped. {T}: Add {G} or {W}. {2}{G}{W}: This land becomes a 3/3 green and white Llama creature until end of turn. It's still a land. Whenever this land attacks, other creatures you control get +1/+1 until end of turn.
Restless Reef | [] | This land enters tapped. {T}: Add {U} or {B}. {2}{U}{B}: Until end of turn, this land becomes a 4/4 blue and black Shark creature with deathtouch. It's still a land. Whenever this land attacks, target player mills four cards.
Restless Ridgeline | [] | This land enters tapped. {T}: Add {R} or {G}. {2}{R}{G}: This land becomes a 3/4 red and green Dinosaur creature until end of turn. It's still a land. Whenever this land attacks, another target attacking creature gets +2/+0 until end of turn. Untap that creature.
Restless Spire | [] | This land enters tapped. {T}: Add {U} or {R}. {U}{R}: Until end of turn, this land becomes a 2/1 blue and red Elemental creature with "During your turn, this creature has first strike." It's still a land. Whenever this land attacks, scry 1.
Restless Vents | [] | This land enters tapped. {T}: Add {B} or {R}. {1}{B}{R}: Until end of turn, this land becomes a 2/3 black and red Insect creature with menace. It's still a land. Whenever this land attacks, you may discard a card. If you do, draw a card.
Restless Vinestalk | [] | This land enters tapped. {T}: Add {G} or {U}. {3}{G}{U}: Until end of turn, this land becomes a 5/5 green and blue Plant creature with trample. It's still a land. Whenever this land attacks, up to one other target creature has base power and toughness 3/3 until end of turn.
Rustvale Bridge | [] | This land enters tapped. Indestructible {T}: Add {R} or {W}.
Salt Marsh | [] | This land enters tapped. {T}: Add {U} or {B}.
Secret Passage | [] | This land enters tapped. {T}: Add {U} or {B}. {4}, {T}: Investigate. (Create a Clue token. It's an artifact with "{2}, Sacrifice this token: Draw a card.")
Shambling Vent | [] | This land enters tapped. {T}: Add {W} or {B}. {1}{W}{B}: This land becomes a 2/3 white and black Elemental creature with lifelink until end of turn. It's still a land.
Shivan Oasis | [] | This land enters tapped. {T}: Add {R} or {G}.
Silverbluff Bridge | [] | This land enters tapped. Indestructible {T}: Add {U} or {R}.
Silverquill Campus | [] | This land enters tapped. {T}: Add {W} or {B}. {4}, {T}: Scry 1.
Skybridge Towers | [] | This land enters tapped. {T}: Add {W} or {U}. {2}{W}{U}, {T}, Sacrifice this land: Draw a card.
Slagwoods Bridge | [] | This land enters tapped. Indestructible {T}: Add {R} or {G}.
Stirring Wildwood | [] | This land enters tapped. {T}: Add {G} or {W}. {1}{G}{W}: Until end of turn, this land becomes a 3/4 green and white Elemental creature with reach. It's still a land.
Stone Quarry | [] | This land enters tapped. {T}: Add {R} or {W}.
Study | [] | This land enters tapped. {T}: Add {W} or {U}. {4}, {T}: Investigate. (Create a Clue token. It's an artifact with "{2}, Sacrifice this token: Draw a card.")
Submerged Boneyard | [] | This land enters tapped. {T}: Add {U} or {B}.
Tanglepool Bridge | [] | This land enters tapped. Indestructible {T}: Add {G} or {U}.
Temple of Abandon | [] | This land enters tapped. When this land enters, scry 1. (Look at the top card of your library. You may put that card on the bottom.) {T}: Add {R} or {G}.
Temple of Deceit | [] | This land enters tapped. When this land enters, scry 1. (Look at the top card of your library. You may put that card on the bottom.) {T}: Add {U} or {B}.
Temple of Enlightenment | [] | This land enters tapped. When this land enters, scry 1. (Look at the top card of your library. You may put that card on the bottom.) {T}: Add {W} or {U}.
Temple of Epiphany | [] | This land enters tapped. When this land enters, scry 1. (Look at the top card of your library. You may put that card on the bottom.) {T}: Add {U} or {R}.
Temple of Malady | [] | This land enters tapped. When this land enters, scry 1. (Look at the top card of your library. You may put that card on the bottom.) {T}: Add {B} or {G}.
Temple of Malice | [] | This land enters tapped. When this land enters, scry 1. (Look at the top card of your library. You may put that card on the bottom.) {T}: Add {B} or {R}.
Temple of Mystery | [] | This land enters tapped. When this land enters, scry 1. (Look at the top card of your library. You may put that card on the bottom.) {T}: Add {G} or {U}.
Temple of Plenty | [] | This land enters tapped. When this land enters, scry 1. (Look at the top card of your library. You may put that card on the bottom.) {T}: Add {G} or {W}.
Temple of Silence | [] | This land enters tapped. When this land enters, scry 1. (Look at the top card of your library. You may put that card on the bottom.) {T}: Add {W} or {B}.
Temple of Triumph | [] | This land enters tapped. When this land enters, scry 1. (Look at the top card of your library. You may put that card on the bottom.) {T}: Add {R} or {W}.
Thornglint Bridge | [] | This land enters tapped. Indestructible {T}: Add {G} or {W}.
Timber Gorge | [] | This land enters tapped. {T}: Add {R} or {G}.
Tramway Station | [] | This land enters tapped. {T}: Add {B} or {R}. {2}{B}{R}, {T}, Sacrifice this land: Draw a card.
Tranquil Expanse | [] | This land enters tapped. {T}: Add {G} or {W}.
Tresserhorn Sinks | [] | This land enters tapped. {T}: Add {B} or {R}.
Urborg Volcano | [] | This land enters tapped. {T}: Add {B} or {R}.
Wandering Fumarole | [] | This land enters tapped. {T}: Add {U} or {R}. {2}{U}{R}: Until end of turn, this land becomes a 1/4 blue and red Elemental creature with "{0}: Switch this creature's power and toughness until end of turn." It's still a land.
Waterfront District | [] | This land enters tapped. {T}: Add {U} or {B}. {2}{U}{B}, {T}, Sacrifice this land: Draw a card.
Witherbloom Campus | [] | This land enters tapped. {T}: Add {B} or {G}. {4}, {T}: Scry 1.
Woodland Stream | [] | This land enters tapped. {T}: Add {G} or {U}.