Choice gates:
Black Dragon Gate | ['Gate'] | This land enters tapped. As this land enters, choose a color other than black. {T}: Add {B} or one mana of the chosen color.
Citadel Gate | ['Gate'] | This land enters tapped. As this land enters, choose a color other than white. {T}: Add {W} or one mana of the chosen color.
Cliffgate | ['Gate'] | This land enters tapped. As this land enters, choose a color other than red. {T}: Add {R} or one mana of the chosen color.
Manor Gate | ['Gate'] | This land enters tapped. As this land enters, choose a color other than green. {T}: Add {G} or one mana of the chosen color.
Sea Gate | ['Gate'] | This land enters tapped. As this land enters, choose a color other than blue. {T}: Add {U} or one mana of the chosen color.

Choice non-gates:
Thriving Bluff | [] | This land enters tapped. As it enters, choose a color other than red. {T}: Add {R} or one mana of the chosen color.
Thriving Grove | [] | This land enters tapped. As it enters, choose a color other than green. {T}: Add {G} or one mana of the chosen color.
Thriving Heath | [] | This land enters tapped. As it enters, choose a color other than white. {T}: Add {W} or one mana of the chosen color.
Thriving Isle | [] | This land enters tapped. As it enters, choose a color other than blue. {T}: Add {U} or one mana of the chosen color.
Thriving Moor | [] | This land enters tapped. As it enters, choose a color other than black. {T}: Add {B} or one mana of the chosen color.

Bounce lands:
Azorius Chancery | [] | This land enters tapped. When this land enters, return a land you control to its owner's hand. {T}: Add {W}{U}.
Boros Garrison | [] | This land enters tapped. When this land enters, return a land you control to its owner's hand. {T}: Add {R}{W}.
Dimir Aqueduct | [] | This land enters tapped. When this land enters, return a land you control to its owner's hand. {T}: Add {U}{B}.
Golgari Rot Farm | [] | This land enters tapped. When this land enters, return a land you control to its owner's hand. {T}: Add {B}{G}.
Gruul Turf | [] | This land enters tapped. When this land enters, return a land you control to its owner's hand. {T}: Add {R}{G}.
Guildless Commons | [] | This land enters tapped. When this land enters, return a land you control to its owner's hand. {T}: Add {C}{C}.
Izzet Boilerworks | [] | This land enters tapped. When this land enters, return a land you control to its owner's hand. {T}: Add {U}{R}.
Orzhov Basilica | [] | This land enters tapped. When this land enters, return a land you control to its owner's hand. {T}: Add {W}{B}.
Rakdos Carnarium | [] | This land enters tapped. When this land enters, return a land you control to its owner's hand. {T}: Add {B}{R}.
Selesnya Sanctuary | [] | This land enters tapped. When this land enters, return a land you control to its owner's hand. {T}: Add {G}{W}.
Simic Growth Chamber | [] | This land enters tapped. When this land enters, return a land you control to its owner's hand. {T}: Add {G}{U}.

Monocolor bounces:
The other bouncelands:
Dormant Volcano | [] | This land enters tapped. When this land enters, sacrifice it unless you return an untapped Mountain you control to its owner's hand. {T}: Add {C}{R}.
Everglades | [] | This land enters tapped. When this land enters, sacrifice it unless you return an untapped Swamp you control to its owner's hand. {T}: Add {C}{B}.
Jungle Basin | [] | This land enters tapped. When this land enters, sacrifice it unless you return an untapped Forest you control to its owner's hand. {T}: Add {C}{G}.
Karoo | [] | This land enters tapped. When this land enters, sacrifice it unless you return an untapped Plains you control to its owner's hand. {T}: Add {C}{W}.
Coral Atoll | [] | This land enters tapped. When this land enters, sacrifice it unless you return an untapped Island you control to its owner's hand. {T}: Add {C}{U}.

Sac lands (two cycles):
Abandoned Outpost | [] | This land enters tapped. {T}: Add {W}. {T}, Sacrifice this land: Add one mana of any color.
Bog Wreckage | [] | This land enters tapped. {T}: Add {B}. {T}, Sacrifice this land: Add one mana of any color.
Ravaged Highlands | [] | This land enters tapped. {T}: Add {R}. {T}, Sacrifice this land: Add one mana of any color.
Seafloor Debris | [] | This land enters tapped. {T}: Add {U}. {T}, Sacrifice this land: Add one mana of any color.
Timberland Ruins | [] | This land enters tapped. {T}: Add {G}. {T}, Sacrifice this land: Add one mana of any color.
Ancient Spring | [] | This land enters tapped. {T}: Add {U}. {T}, Sacrifice this land: Add {W}{B}.
Dwarven Ruins | [] | This land enters tapped. {T}: Add {R}. {T}, Sacrifice this land: Add {R}{R}.
Ebon Stronghold | [] | This land enters tapped. {T}: Add {B}. {T}, Sacrifice this land: Add {B}{B}.
Geothermal Crevice | [] | This land enters tapped. {T}: Add {R}. {T}, Sacrifice this land: Add {B}{G}.
Havenwood Battleground | [] | This land enters tapped. {T}: Add {G}. {T}, Sacrifice this land: Add {G}{G}.
Irrigation Ditch | [] | This land enters tapped. {T}: Add {W}. {T}, Sacrifice this land: Add {G}{U}.
Ruins of Trokair | [] | This land enters tapped. {T}: Add {W}. {T}, Sacrifice this land: Add {W}{W}.
Sulfur Vent | [] | This land enters tapped. {T}: Add {B}. {T}, Sacrifice this land: Add {U}{R}.
Svyelunite Temple | [] | This land enters tapped. {T}: Add {U}. {T}, Sacrifice this land: Add {U}{U}.
Tinder Farm | [] | This land enters tapped. {T}: Add {G}. {T}, Sacrifice this land: Add {R}{W}.

Vivid lands:
Vivid Crag | [] | This land enters tapped with two charge counters on it. {T}: Add {R}. {T}, Remove a charge counter from this land: Add one mana of any color.
Vivid Creek | [] | This land enters tapped with two charge counters on it. {T}: Add {U}. {T}, Remove a charge counter from this land: Add one mana of any color.
Vivid Grove | [] | This land enters tapped with two charge counters on it. {T}: Add {G}. {T}, Remove a charge counter from this land: Add one mana of any color.
Vivid Marsh | [] | This land enters tapped with two charge counters on it. {T}: Add {B}. {T}, Remove a charge counter from this land: Add one mana of any color.
Vivid Meadow | [] | This land enters tapped with two charge counters on it. {T}: Add {W}. {T}, Remove a charge counter from this land: Add one mana of any color.

Gain lands:
Akoum Refuge | [] | This land enters tapped. When this land enters, you gain 1 life. {T}: Add {B} or {R}.
Bloodfell Caves | [] | This land enters tapped. When this land enters, you gain 1 life. {T}: Add {B} or {R}.
Blossoming Sands | [] | This land enters tapped. When this land enters, you gain 1 life. {T}: Add {G} or {W}.
Dismal Backwater | [] | This land enters tapped. When this land enters, you gain 1 life. {T}: Add {U} or {B}.
Graypelt Refuge | [] | This land enters tapped. When this land enters, you gain 1 life. {T}: Add {G} or {W}.
Jungle Hollow | [] | This land enters tapped. When this land enters, you gain 1 life. {T}: Add {B} or {G}.
Jwar Isle Refuge | [] | This land enters tapped. When this land enters, you gain 1 life. {T}: Add {U} or {B}.
Kazandu Refuge | [] | This land enters tapped. When this land enters, you gain 1 life. {T}: Add {R} or {G}.
Rugged Highlands | [] | This land enters tapped. When this land enters, you gain 1 life. {T}: Add {R} or {G}.
Scoured Barrens | [] | This land enters tapped. When this land enters, you gain 1 life. {T}: Add {W} or {B}.
Sejiri Refuge | [] | This land enters tapped. When this land enters, you gain 1 life. {T}: Add {W} or {U}.
Swiftwater Cliffs | [] | This land enters tapped. When this land enters, you gain 1 life. {T}: Add {U} or {R}.
Thornwood Falls | [] | This land enters tapped. When this land enters, you gain 1 life. {T}: Add {G} or {U}.
Tranquil Cove | [] | This land enters tapped. When this land enters, you gain 1 life. {T}: Add {W} or {U}.
Wind-Scarred Crag | [] | This land enters tapped. When this land enters, you gain 1 life. {T}: Add {R} or {W}.

Typeless tritaps:
Arcane Sanctum | [] | This land enters tapped. {T}: Add {W}, {U}, or {B}.
Crumbling Necropolis | [] | This land enters tapped. {T}: Add {U}, {B}, or {R}.
Frontier Bivouac | [] | This land enters tapped. {T}: Add {G}, {U}, or {R}.
Jungle Shrine | [] | This land enters tapped. {T}: Add {R}, {G}, or {W}.
Mystic Monastery | [] | This land enters tapped. {T}: Add {U}, {R}, or {W}.
Nomad Outpost | [] | This land enters tapped. {T}: Add {R}, {W}, or {B}.
Opulent Palace | [] | This land enters tapped. {T}: Add {B}, {G}, or {U}.
Sandsteppe Citadel | [] | This land enters tapped. {T}: Add {W}, {B}, or {G}.
Savage Lands | [] | This land enters tapped. {T}: Add {B}, {R}, or {G}.
Seaside Citadel | [] | This land enters tapped. {T}: Add {G}, {W}, or {U}.